12
1,5,5,7,5,5,7,7,5,5,5,6
3,7,5,13,5,5,15,13,5,5,6,10
10,9,5,5,5,6,9,5,5,5,12,10
11,5,5,5,6,9,5,5,5,6,3,14
11,5,5,5,15,5,5,7,6,10,10,10
9,5,7,6,10,3,6,9,12,10,10,10
3,6,10,10,10,9,13,5,5,14,10,10
10,10,10,10,11,7,5,5,6,10,10,10
10,10,10,10,11,15,5,5,14,10,9,14
10,10,9,13,13,15,5,5,13,15,4,10
9,13,5,7,5,13,5,5,5,13,5,14
1,5,5,13,5,5,5,5,5,5,5,12
